################
#------------ww#
A-^^^^^^^^^^-wwB
#^^----------ww#
##^^----^^^^www#
##^--^^^^-$wwww#
###-----^-wwwww#
#######---wwwww#
################
